Acceptance,BCPM,GPA,VR,PS,WS,BS,MCAT,Apps
1,3.85,3.89,11,12,6,11,40,5
0,3.29,3.3,11,8,6,7,32,15
1,3.51,3.54,9,10,9,11,39,1
0,3.27,3.25,8,9,5,10,32,5
1,3.95,3.89,13,14,8,13,48,5
1,3.41,3.58,11,11,6,9,37,14
0,3.08,3.4,8,6,4,9,27,7
1,3.1,3.14,10,9,8,11,38,12
0,3.25,3.36,11,8,9,12,40,12
1,3.98,3.97,11,13,10,14,48,6
0,3.12,3.29,11,10,8,8,37,12
0,3.36,3.44,11,11,8,9,39,1
