Acceptance,BCPM,GPA,VR,PS,WS,BS,MCAT,Apps
1,3.74,3.69,12,11,7,10,40,5
1,3.74,3.71,8,10,6,11,35,5
1,3.86,3.89,9,9,6,10,34,11
1,4,3.97,11,9,8,11,39,6
1,3.26,3.54,12,8,8,10,38,6
0,3.75,3.65,8,8,8,11,35,6
0,3.38,3.44,11,9,4,8,32,10
1,3.87,3.86,10,11,8,11,40,8
0,3.56,3.37,6,8,9,8,31,4
0,3.19,3.37,10,9,6,9,34,5
0,3.53,3.67,12,10,9,8,39,6
